__________
333333333_
222222222_
11111111__
__________