__________
333333333_
222222222_
111111111_
__________