__________
222222222_
111111111_
__________
__________