__________
222222222_
11111111__
__________
__________