__________
555555555_
444444444_
333333333_
__________