__________
__________
__________
_____xxxx_
__xxxxxxx_
____x_x_x_
______x___