__________
444444444_
333333333_
222222222_
__________